 . @    # #
 $ $ .   #
## #     #
   #$ # ##
   #  # ##
#  ## # ##
## #     #
#      # #
#   .#.  #
