@  #  .##
   #  . #
# ###   #
# # $$#  
# $      
### ##   
##  ###  
##     . 
##      #
