@  ###.  
     #$$.
# # $  ##
     ####
  #  #  #
###     #
  #  ## #
         
  #. ##  
