@     #  
.$ #  $$ 
#  ### . 
## ### ##
## #    #
##    . #
#  ######
#    #  #
##      #
