@     ###
  # $ #  
#### ##  
         
      #  
# # #####
  #   ###
 . #$$###
   #..###
