@      ##
    #.$ #
######  #
    $  ##
   #.   #
   ###  #
###   *  
###   #  
####  #  
