@ #  #   
     # . 
# #  ##  
  #  ##  
     #.  
  ####  #
#     #  
# $ $ *  
##      #
